11111111111111111111111111111111111
10000000100000000000001000100000001
11111110101111111011101011101011101
10000010101000000010001000001010001
10101110111011111110111111101010111
10100010000010000010000000101010001
10111011111111101011111110111011101
10101000100000101010000010000010101
10101011101010101011101011111110101
10001010001010001000101000100010001
11101010111011111110111010101010111
10001000100010001000000010101000101
10111111101110111011111110101111101
10100000101000000010001010100000101
10111011101111111110101010111110101
10001000100000100000101010001000101
11101110111110101111101011101011101
10101000001010001000101000001000101
10101011101011111011101111111110101
10100010001000001010001000000000101
10111110111011101010111011111111101
10000000000010000010000000000000001
11111111111111111111111111111111111
